################
#............#.#
#..............#
#..............#
#.#...G.##.....#
#.#..####......#
#.#........#...#
#..........##..#
#..........##..#
#....P.........#
#..........##..#
#.##...........#
#.##...........#
#..#...........#
#.............##
################