################
#..............#
#..............#
#..............#
#..............#
#..............#
#..G.##.......##
#....##........#
#..............#
####...........#
#..............#
#..............#
#.........#....#
#.........#....#
#P........#....#
################