################
#..............#
#..............#
###......##.G..#
###.......#....#
#....#.........#
#....#.........#
#....#.........#
#...##.........#
#..........##..#
#..P........##.#
#....####......#
#..............#
#..............#
#..#..........##
################