################
#..............#
#..............#
#.........G..#.#
#...##..##..##.#
#...##..##..##.#
#..............#
#.....P........#
#...##..##.....#
#...##..##.....#
#...........##.#
#...##..##..##.#
#...##.........#
#............###
#............###
################