################
#..............#
#..............#
#..............#
#..............#
#..............#
#..............#
#.......G......#
#..............#
#..............#
#..............#
#..............#
#..............#
#..............#
#P.............#
################