################
##............P#
##......#......#
##......#......#
#.......#.G....#
#.......#......#
#...#..........#
#...#...#...#..#
#...#..........#
#..............#
#.....#.......##
#.....#........#
#..............#
#..............#
#..............#
################